21 21
2 2 2 2 2 2 2 2 2 2 2 2 2 2 2 2 2 2 2 2 2 
2 3 3 3 2 3 3 3 3 3 2 3 3 3 3 3 2 3 3 3 2 
2 3 2 3 2 3 2 2 2 3 2 3 2 3 2 3 2 3 2 3 2 
2 3 2 3 2 3 2 3 3 3 2 3 2 3 2 3 3 1 2 3 2 
2 3 2 3 2 2 2 3 2 3 2 3 2 3 2 3 2 2 2 3 2 
2 3 2 3 3 3 3 3 2 3 3 3 2 3 2 3 2 3 3 3 2 
2 3 2 2 2 2 2 3 2 2 2 2 2 3 2 2 2 3 2 2 2 
2 3 3 3 2 3 3 3 3 3 3 3 2 3 2 3 3 3 3 3 2 
2 2 2 3 2 2 2 3 2 3 2 2 2 2 2 2 2 3 2 2 2 
2 3 3 3 2 3 2 3 2 3 3 3 3 3 2 3 2 3 2 3 2 
2 2 2 2 2 3 2 2 2 2 2 3 2 2 2 3 2 3 2 3 2 
2 3 3 3 2 3 3 3 2 3 3 3 2 3 3 3 2 3 3 3 2 
2 3 2 2 2 3 2 3 2 2 2 3 2 3 2 3 2 3 2 2 2 
2 3 3 3 3 3 2 3 3 3 2 3 2 3 2 3 3 3 2 3 2 
2 3 2 3 2 3 2 2 2 2 2 2 2 3 2 2 2 3 2 3 2 
2 3 2 3 2 3 3 3 3 3 2 3 2 3 2 3 3 3 3 3 2 
2 2 2 3 2 3 2 2 2 3 2 3 2 2 2 2 2 3 2 2 2 
2 3 3 3 2 3 2 3 3 3 3 3 2 3 2 3 3 3 2 3 2 
2 2 2 3 2 2 2 3 2 2 2 3 2 3 2 3 2 2 2 3 2 
2 3 3 3 2 3 3 3 3 3 2 3 3 3 3 3 3 0 3 3 2 
2 2 2 2 2 2 2 2 2 2 2 2 2 2 2 2 2 2 2 2 2 
0.830368 0.670406
